0,0,1,2
1,0,1,2,3
2,0,1,2,3,4
3,0,2,3,5,6
4,1,3,4,5,7
5,0,2,3,4,6
6,1,2,4,5,6,7
7,0,1,3,4,6,8
8,0,1,2,4,6,7,9
9,1,2,3,5,6,7,8,10
10,0,2,3,4,7,8,9,11
11,1,2,4,5,8,9,10,12
12,0,1,3,4,7,9,10,13
13,0,1,2,4,6,8,10,11,14
14,1,2,3,5,6,9,11,12,15
15,0,2,3,4,7,8,11,12,16
16,1,3,4,5,8,9,12,13,17
17,0,2,4,5,8,10,13,14,18
18,1,3,5,6,9,11,14,15,19
19,0,2,4,6,8,10,12,15,16,20
20,1,3,5,7,9,11,13,16,17,21
21,0,2,4,6,8,10,12,14,17,18,22
22,1,3,5,7,9,11,13,15,18,19,23
23,2,4,6,8,10,12,14,16,19,20