0,0,1,2,3,10,11,30,176,224
1,34,35,36,37,44,45,69
2,1,2,8,9,10,11,26,27,30,34,35,42,43,44,45
3,0,1,8,9,10,26,31,32,35,36,44,45,64,65,66,69
4,0,1,2,3,8,9,10,11,26,27,30,34,35,36,37,42,43,44,45,65,66,69,173,176,224
5,0,1,2,3,8,9,10,11,26,27,30,34,35,36,37,42,43,44,45,65,66,69,173,176,224
6,0,1,2,3,8,9,10,11,26,27,30,34,35,36,37,42,43,44,45,65,66,69,173,176,224
7,0,1,2,3,8,9,10,11,26,27,30,34,35,36,37,42,43,44,45,64,65,66,69,173,176,224
8,0,1,2,3,8,9,10,11,26,27,30,34,35,36,37,42,43,44,45,64,65,66,69,173,176,224
9,0,1,2,3,8,9,10,11,26,27,30,34,35,36,37,42,43,44,45,64,65,66,69,173,176,218,224,229,248
10,0,1,2,4,5,6,7,8,10,12,14,17,18,34,35,38,39,40,41,42,43,44,45,46,47
11,0,1,4,5,6,7,8,9,10,11,12,13,14,15,16,17,18,19,20,21,22,23,24,25,26,27,28,29,30,31,32,33,36,37,38,39,40,41,42,43,44,45,46,47,48,49,50
12,0,1,4,5,6,7,8,9,10,11,12,13,14,15,16,17,18,19,20,21,22,23,24,25,26,27,28,29,30,31,32,33,36,37,38,39,40,41,42,43,44,45,46,47,48,49,50,51,52,53,54,55,56,57,58,59,60,61,62,63,64,65,66,67,68,69,70,71,72
13,0,1,4,5,6,7,8,9,10,11,12,13,14,15,16,17,18,19,20,21,22,23,24,25,26,27,28,29,30,31,32,33,36,37,38,39,40,41,42,43,44,45,46,47,48,49,50,51,52,53,54,55,56,57,58,59,60,61,62,63,64,65,66,67,68,69,70,71,72
14,0,1,2,3,6,7,8,9,10,11,12,13,14,15,16,17,18,19,20,21,22,23,24,25,26,27,28,29,30,31,32,33,34,35,36,37,38,39,40,41,42,43,44,45,46,47
15,0,1,2,3,6,7,8,9,10,11,12,13,14,15,16,17,18,19,20,21,22,23,24,25,26,27,28,29,30,31,32,33,34,35,36,37,38,39,40,41,42,43,44,45,46,47
16,0,1,2,3,4,5,6,7,8,9,10,11,12,13,14,15,16,17,18,19,20,21,22,23,24,25,26,27,28,29,30,31,32,33,34,35,36,37,38,39,40,41,42,43,44,45,46,47,48,49,50,51,52,53,54,55,56,57,58,59,60,61,62,63,64,65,66,67,68,69,70,71,72
17,0,1,2,3,4,5,6,7,8,9,10,11,12,13,14,15,16,17,18,19,20,21,22,23,24,25,26,27,28,29,30,31,32,33,34,35,36,37,38,39,40,41,42,43,44,45,46,47,48,49,50,51,52,53,54,55,56,57,58,59,60,61,62,63,64,65,66,67,68,69,70,71,72
18,0,1,2,3,4,5,6,7,8,9,10,11,12,13,14,15,16,17,18,19,20,21,22,23,24,25,26,27,28,29,30,31,32,33,34,35,36,37,38,39,40,41,42,43,44,45,46,47,48,49,50,51,52,53,54,55,56,57,58,59,60,61,62,63,64,65,66,67,68,69,70,71,72
19,73,74,75,76,77,78,79,80,81,82,83,84,85,86
20,73,74,75,76,77,78,79,80,81,82,83,84,85,86,112,113,114,115,116,117,118,119,120,121,122,123,124,125
21,0,1,2,3,8,9,10,11,26,27,30,34,35,36,37,42,43,44,45,64,65,66,69,173,176,218,224,229,248, 73, 84, 124, 110, 297, 102, 313, 150, 290, 116
22,0,1,2,3,8,9,10,11,26,27,30,34,35,36,37,42,43,44,45,64,65,66,69,173,176,218,224,229,248,79, 85, 122, 108, 260, 130, 305, 312, 143, 251
23,0,1,4,5,6,7,8,9,10,11,12,13,14,15,16,17,18,19,20,21,22,23,24,25,26,27,28,29,30,31,32,33,36,37,38,39,40,41,42,43,44,45,46,47,48,49,50,77, 88, 118, 121, 292, 132, 307, 117, 302, 255
24,0,1,4,5,6,7,8,9,10,11,12,13,14,15,16,17,18,19,20,21,22,23,24,25,26,27,28,29,30,31,32,33,36,37,38,39,40,41,42,43,44,45,46,47,48,49,50,76, 86, 128, 122, 271, 137, 293, 298, 304, 119
25,0,1,4,5,6,7,8,9,10,11,12,13,14,15,16,17,18,19,20,21,22,23,24,25,26,27,28,29,30,31,32,33,36,37,38,39,40,41,42,43,44,45,46,47,48,49,50,51,52,53,54,55,56,57,58,59,60,61,62,63,64,65,66,67,68,69,70,71,72,97, 89, 115, 120, 273, 289, 136, 303, 307, 129
26,0,1,2,3,4,5,6,7,8,9,10,11,12,13,14,15,16,17,18,19,20,21,22,23,24,25,26,27,28,29,30,31,32,33,34,35,36,37,38,39,40,41,42,43,44,45,46,47,48,49,50,51,52,53,54,55,56,57,58,59,60,61,62,63,64,65,66,67,68,69,70,71,72,81, 95, 129, 125, 258, 141, 294, 291, 309, 110
27,0,1,2,3,4,5,6,7,8,9,10,11,12,13,14,15,16,17,18,19,20,21,22,23,24,25,26,27,28,29,30,31,32,33,34,35,36,37,38,39,40,41,42,43,44,45,46,47,48,49,50,51,52,53,54,55,56,57,58,59,60,61,62,63,64,65,66,67,68,69,70,71,72,94, 91, 113, 113, 299, 142, 264, 316, 300, 261
28,0,1,2,3,4,5,6,7,8,9,10,11,12,13,14,15,16,17,18,19,20,21,22,23,24,25,26,27,28,29,30,31,32,33,34,35,36,37,38,39,40,41,42,43,44,45,46,47,48,49,50,51,52,53,54,55,56,57,58,59,60,61,62,63,64,65,66,67,68,69,70,71,72,83, 97, 112, 133, 312, 148, 266, 315, 311, 267
29,317